XXXXXXXXXX
XS.....G.X
X........X
X........X
X........X
X........X
X........X
X........X
X........X
XXXXXXXXXX