XXXXXXXXXX
X........X
X........X
X....G...X
X....X...X
X........X
X........X
X.....XXXX
X......S.X
XXXXXXXXXX