XXXXXXXXXX
XS.......X
X........X
XXXXX....X
X....X...X
X........X
X........X
X.....XXXX
X........X
XXXXXXXXXX